**************************
*........................*
*.**..**..**..**..**.**..*
*.**..**..**..**..**.**..*
*.**..**..**..**..**.**..*
*.**..**..**..**..**.**..*
*........................*
**************************
