********************
*..................*
*.**....**...**....*
*....**....*....**.*
*..................*
**********2*********
